1st Floor (Floor of Doom)
22
8
###################
# H   #  K  #   GH#
#-#    #   #    H #
#H#HG   #-#G   H  #
# # H     #   HG  #
#H#  #####HHHH    #
# # H#      #    G#
#H#H #    ###     #
# #G # H  #B B B B#
# # G#  # # B B B #
#H#  #    #B B B B#
# #H #G#  ##B B BW#
#H# H# G  #K B B B#
# #H #  G ##B B B #
#H#  #  H #B B B B#
# #  #    # B B B #
# #B# #   #B B B  #
#H# HB B  # B B   #
#K## PK|H #B B   X#
###################