basement (tutorial)
22
8
###################
#              G  #
#   G            K#
#                 #
#         G       #
###-###############
#  B     G # G   W#
#     HH   #      #
#     H           #
#  G       #      #
#        K #      #
###-###########-###
#G B #         B  #
#    #           G#
#    #   ##########
#    #   #     G  #
#    #        H   #
#HH  #   #        #
#P  K# X #G     K #
###################